wwwwwwwwwwww
rnq rp rp nr
wqw  qn ww w
r nb   r  pr
wpw   pq n r
rbwn r w wbw
rs wn rp   r
wwwwwwwwwwww
