nq rp rp  w 
w    qn w ww
 n ww      p
w   pb      
p   wp w n r
 b     w   w
w w  wp     
s    r  w   
